NO /NO.xmp
SO /SO.xmp
EA /EA.xmp
WE /WE.xmp
C 100,100,100
F 100,1000,100

11111111111111111111111111111111111111111111111111
10000000000100000000010000001001001000101000000001
11001110010000000100010011100100010010000100000101
10010001100100001001100100010001001000110001000101
100000S0000100010010001000101110100110000100101001
10011100010100010010010010000000010000110010000011
10100011001000100001001001001100100111000001010001
10101000100100001000100100010010001000101101010101
11001100110101000101000110010001101010010010001001
10010001000001010101001000100100001001010001101001
10100111110010010110010011000100001101000100001001
10101001000000010000010100010000010001100010000101
11111111111111111111111111111111111111111111111111
