NO /NO.xpm
SO /SO.xpm
EA /EA.xpm
WE /WE.xpm
C 1,1,1
F 2,2,2

11111111111111111111111111111111111111111111111111
10010000101010000100000000001000000100000010000011
10000010000000100011100010101111000001100010001001
10101001001100010100011100100000100100001001000101
10100101010010010101000001010110001011110001010001
10010101010001000100101100001000100000001010001101
10100101010100100010010010100010100010101010100011
10010010000101001010010000011000001010010010011001
10011001100001010010001001000111110010010100100101
10100100000110000100100110110000000001010100100101
10000111001000100111001000001000100110010000001001
10111000010001000000001001000110001000001010001001
11N00010100101011010101010110001001011010010001011
10011100101001000101001010001100101000100101110001
10100010101001010101010010100010100010101000001101
10010000101001010101010100100010110100101000100001
11001001000101010100010101001010001000100100011101
10100100010100100010010010010010101010110101100001
10010011000110000100101010101001001001000100000111
10011000111000000001001010000101010001000101010001
10000010000111110100001010010001000100100100011111
10110011010000000010010010001010101001000010100001
10001000100011001000001010001000101010000010001001
10101100001000100110010010010000101010010000000101
10100011100010110000100000100100101011010100011001
10001000010001001000011100100000101000010010100001
11010011001010000100100001001001001001100101001101
10000100101100100001001100010101010010000001010001
10110000100010010000100001010001010011101100010011
10000000111001011101010010011101010000010010101001
10100111000101000010001010100010001000010000100101
10111000010001001000100010001000101110000110001001
10000011001010001100110001000010010000100001010011
11110100100001110011000100111000000101001010000001
10000000010100000100010010000100111001010000110011
10101110010011100101001100010001000001000110000001
10100000101000010000110001111110001000001001000101
10011111000000001010000100010001101000010001010001
10100000010111010011111011000010001111000100001001
10010011010000100100000000101100100000000011110011
10011000100010101000110100100000000100010100000001
10000100010100100001001000100100001001000101111101
11010001010101010010001010100000110001000100000001
10101100010100001100010001001010000000100100011001
10000010010110100010001010001011100010100011100001
10010001001001110010101000001000010001000100001001
10100110010000100010000110010011001110001000100011
10101000010010101001001001100100100000100001010101
10100010000100001000000000000000010010000000000001
11111111111111111111111111111111111111111111111111
