NO /NO.xpm
SO /SO.xpm
EA /EA.xpm
WE /WE.xpm
C 1,1111,11111
F 111,11111,1111

11111111111111111111111111111111111111111111111111
10000001001000000000000000001000010010000010000011
10010100100001000010011001100010000011101010001001
10010010010010001010000010001101110000001010100101
10010101010010100010101100010000001111010010001001
10100100011100010010010010010100100000101001001011
10000110000011000101001001010011010010100101101001
10001000001000100000101000010100001010100000000101
10010010110100101000100111100010100100111110010101
11010001000001000100010000001010100010000001001001
10010100010010010110010001000010011100100100100001
10101000111101010000100010100000100000100010011111
10000001010000001000010010010010101010001100000001
10010101010011100101001001001100001001110010000101
11100101000100010100101000100000000100000001001001
10000100101001001000000100010101010010010101001001
10100010010010100011010010100101001100001000101011
10010010010100100000010010001000110010101000001001
11001000000100001110001011110000000010100110010101
10100111110111110000100000000101110000110000100001
10010000001000000101001101110010000011001100000101
10010000100001000000010010001000111100000001111001
10100101000010010011010001100001000001110010N00101
10000100010010001000000100000110010010001100100101
10010111101010110110100000001000100100100000010011
10001000001010000000001110001001000101001110101001
10100011101010100101100001000100111001000001000101
10010000000010010100010101000100000001010001010001
10001001011000001001010010010001001001010001001111
10100001000100010010001010101100000000010000100001
10101110010000010101100010100010110110000110011001
10010000010010000000011100010001001000011001100101
11010010100000101110000000100100001110100000000101
10010100000110100001110100001111100001000111010001
10011001001001010100001000100100011001011000101001
10100001010000000100100001110010000010000010100001
10000100100011000011000000101000100010001100010101
11100001001100101100111110000101000010100010010011
10001110010010000000000000110100100010000001001001
10100000100000111000000001000010100010111110010001
10011100001001000000111110000100100101000000100011
11000010100110010101000000101001000100010101010001
10111011000000100100011001001010011001001010010011
10000000010010001011000010100010100010100000100001
10010100011001000000110100000000001010100101000011
10100010000100011110001010001001001010101000010001
10101011110101100001001000100100001010101010011001
10101000000010001100101010110110010010001000000101
10001000100000100000001010000000000100000001000001
11111111111111111111111111111111111111111111111111