NO /NO.xmp
SO /SO.xmp
EA /EA.xmp
WE /WE.xmp
C 100,100,100
F 100,100,100

111111111111111111
100000000000000001
110000000000000001
100100000000000001
10000000W000000011
100000000000000011
101000000000000001
111111111111111111