NO /NO.xpm
SO /SO.xpm
EA /EA.xpm
WE /WE.xpm
C 0,00,000
F 000,0000,0000

11111111111111111111111111111111111111111111111111
10010001000101000100000000010000001000001000000001
10100100010000000001000101010000100000100001111001
10100100010110001100100101000111111100011010000111
10110010001001010000100001111000100001000010010001
10001010100100001001001100000010100000011101001001
10100010000110101010010000001000110011100000100101
10010100010000101010100000110101000100001110001001
11001001000101001000101001000001011000100000010011
10100100001001010111010110011101000010001001100001
10010000101001000000000001000010100101010010001101
10100001001000111011111101001000010001010100100001
10000001010010000100000000110001000101000101000001
10101001010111110100001010001001111010000100111001
11000100100010000011101000100100000010100010000111
10000010001010101000010100110011100010110000010001
10111001101000100101000000001000000100001001101001
10000100001111000010000011110111010011100010000101
10110010000000101010111000000000001100010000010101
11001010101110101001000100101010100001001010101001
10001001010000010100010010010100000001000001000001
10100100000101000010010111000101111000111110011001
10100010001001000010010010100100000111000000100001
10011001100100010100001000010110110000011000010101
11000100011000101011100110010001001100100101001001
10100001000101000000010000100100000000100001100101
10011010100001000101001010100011000111001010010011
10100010010000100100101011001000101000010010001001
10101100010010010101001000100100010011000010101101
10100010001001001001001010110101000100001100100001
10001001010010100101101100000100110000010000111001
10110001000010100100000001001110001100100100000111
10000101001000101001010100100101100011000100010001
10010001001001000110001001010100010000001000011001
10001100001000010001001010000001001110000101000101
10100010100111001100101000001100010000110101011001
10001000010000100010001101010010010101001000100001
10000101010010010011000001100011100000001001001001
10010100000100010000101000001000001010000010010011
10010010110000100110110010000111001000001000100101
10010100001010000000001001010000000100100101001001
110101001010111001010000100E1101100001010101001001
10010110101000001000111100110010011101000101001001
10111000100000000101000001000010000000101001000001
10010011111110000100001110010010011010010010111001
10001000100000010111000001010000100011100100000101
10101100101001001000111101001100000100010010000101
10100001001000110010000010010001111001011010111001
10100000001000000010000000100000000010000010000001
11111111111111111111111111111111111111111111111111
