NO /NO.xpm
SO /SO.xpm
EA /EA.xpm
WE /WE.xpm
C 5,5,5
F 4,5,4

11111111111111111111111111111111111111111111111111
10000001000001001000010001000000000000000010000101
10110000001100001001100101000110010110011000010001
10000111110010100010000101001001001001000101001001
10010000000100011100110001001000100010110101100001
10001001001001000001001001010010001010000100011101
10100101010010101000010001001001010000100111000001
10110010010100101001000010000101010000101000001011
10001010100100101010100100010101011001000010110001
11010010010000101000011001100100000100100100000101
10010101011101000101000100010010100010010001110101
11100100000000101010110010001100100100100010000101
10000011111001001000000000100000100100100100111001
10111000000100101001100110000111001010001001000101
10000100110010101000011001111000001011010010010001
10010100001001001100100000000100110000010001001011
10010010011100000000011110100101000100000100101001
10010000001001001011100001001000000010000010101101
10001101100010001000000100101010111001110000100011
10100010010001010011001010001001000100001100001001
10000100001010000100110000010000001000100011001101
10001001101100110001000100000010100010011000110001
10010010000000001001000000100010011100000010000101
10101001000001000000101111000100000001000101110011
10100100100000111100100000100001000100011000000001
10001010010001000010100100010001001110100010000101
11001010100110010000010011010010000100100101001011
10000010101000001001001100011010111001001000100001
10110100101011000100100001000010000001001010010101
10000101001000100010011101110001001000100011001001
10010000001000011100000010N01000010001010000100001
10101001010010100001001010101011100001000100110101
10100010010001001101010010100100001010100001000101
10111001000110010001100010010001100000001010001001
10000101110000101000000100011110010101001000010001
11100100001010000010001000100001000010010000001001
10010010010010010100010010000100001010001000101001
10000010100101100000100001100011100010101101000011
10100100000000011000100010000100010100010001011001
10000011001111000100010010100101010010100110000101
11111000100000010011100010111001001001001000010001
10000010000100111000000010000010100100000010001101
10010001010010010110001100000000010010010010100001
10100100100011000001000010101111100001001010100001
10101011000100101110000010010000001100100010100011
10100000000000100001111001100100010010010010010101
10101100101100110100000100010010010001001000100101
10010010010001001010000101011001010101000100101001
10000001000000000000100001000010000100010001000001
11111111111111111111111111111111111111111111111111
