NO /NO.xmp
SO /SO.xmp
EA /EA.xmp
WE /WE.xmp
C 100,100,100
F 100,100,100

111111111111111111
100000000001000001
110011100100000001
1001000000000000011
10000000N000001111
1000000000000000101
101000110010001001
111111111111111111