NO /NO.xpm
SO /SO.xpm
EA /EA.xpm
WE /WE.xpm
C 1,1,1
F 11,111,1111

11111111111111111111111111111111111111111111111111
10000100000000100000010100100000000000000001010001
11110000011000101001000000001000110011110100000011
10001001100100000110101010S10001000000000111001001
10101010000101010000010001001001011110000000101111
10001100010001001111010100100101000001001000100001
11000000101100000000000101010001001100101011000101
10010011000010011100111001001000000010101100000101
10100100011000100010000101010010111100100001010101
10001001000110101011100001001011000001010000010001
10101010010001001000011000101000011100000011001011
11001000001100001011000010000000100010101000100001
10010110100001000100010100100100101011000010100101
10000001000010110000010000010010001000000100010001
10101010000100001010011001001001010011100001001011
10100100100010000100100000110010001100011110001001
10110000011000100010001001000010110001000000110101
10000100100100011001010101001001000100010001000001
10100000100110000010010001010001010010010010011001
10001011000001001100101010001101001000010000100101
10000100011000010000101001100010010010001000100101
10010000000100100110001100001000100100110101000001
10001110001001001001100010100100100100000001001011
10100001110000101000001001001011010101001110010001
10011100000110101011010001001000010100010001010011
10100011110000001000000100101010010110011001001001
10101000001001110010100101001010100000000100100101
10011110000100000100101001010100000011010001110011
11001000110101110000100010010010011100101100101001
10001010000100001000011010100001000010000000100101
10001001011010100111000010101100101011100000000101
10101100100001010000100010010010001000011011100101
10100010101010001100011010010010010111000100000101
10100010001000100011000010000001000000100101001001
10100100010111011000100101100010011110001001010001
10101000010000000100010000010100100001001000100101
10101101001110101001101001010010101100000100101011
10100010100000101000000110010010100010100010100001
10100010001111000000110001010100001001011000000101
10001101110000100011000101010101000101000000101001
10010000000100110100010101000100010001000010010001
10001010011001001001000100000100001010001010100101
10100100100010000010101010110010101010101011001001
10010000100100011100101000001000010010001000101001
11000010000101000010100100101101010101010010101001
10001010001000101000110010100000100100000100100101
10100101000010100111000010001010001000110000010101
10011000100100100000001101110001000001000000100101
10000010000000100010000000000010010000001000001001
11111111111111111111111111111111111111111111111111

